aller - allé
apercevoir - aperçu - замечать
apparaître - apparu
apprendre - appris
avoir - eu
boire - bu
comprendre - compris // j'ai pas compris pourquoi
conduire - conduit  // je veux te conduire
connaître - connu  // j'ai bien connu ta mere
construire - construit
croire - cru // il faut nous croire, à ça
cuire - cuit // c'est cuit
devoir - dû // je n'aurai jamais dû y aller
faire - fait // faire ses courses un samedi, faire pleurer bébé
falloir - fallu // il va falloir
dire - dit // dire je t'aime
écrire - écrit // composé, écrit, joué et chanté par Jean Y
être - été //
lire lu
mettre - mis
mourir - mort // sarkoverdose dormir c est mourir un peu
  j dors
  t dors
  i dort
  n dormons
  v dormez
  s dorment
naître - né // Il doit naître dans ces murs.
partir - parti
pouvoir - pu
prendre - pris //  prendre la route, prendre le temps
produire - produit
recevour - reçu // signal reçu
répondre - répondu
rire - ri // le roi du rire
savoir - su
sortir - sorti
sourire - souri
  Désolé, mais je travaille seul.  Прости, пацан, но я работаю один.
  derrière un ssourire
suivre - suivi //
tenir - tenu
traduire - traduit
valoir - valu
vivre - vécu
voir - vu
vouloir - voulu
venir - venu
vivre - vécu
voir - vu
vouloir - voulu
